#########################
#0..#..#....#..#...#....#
#.#.#.##..#....#.#.#.#..#
#...#.#...####.#.#...##.#
###.#.#.###....#.###.#..#
#............###.......##
#.#####.####.....#.###..#
#..........####.##...##.#
#####.####..............#
#........#.####..######1#
#.#.#..#.#...#........###
#...#..#.#.#.#.######...#
##.##....#.#........##..#
#.....####.#.#.##.#.#...#
#..#.##......#....#...###
#..#.#..##.###.#.####..##
####.#.....#...#....##..#
#....#.#####.######..##.#
#.#.....#....#........#.#
#.#####....#.#.#..#.#...#
#.....#..........##.#.###
#.#.#.#..#.#.#.#.#......#
#.#.#.#..........#..#.#.#
#...#.........#.....#...#
#########################