#0.#.....#
..........
.......#..
#...#.....
..........
..........
.....#...#
..#.......
..........
#.....#.1#
