#########################
#0..#...#...#...#.......#
#.#.#.#.#.#.....#.##.##.#
#.....#.#...#.###..#....#
#####.#.#.###......#.####
#.....#.......####.#....#
#.###.#.#....##....####.#
###.....#.##.#...#......#
#...#.#.#....#.#.##.....#
#...#.#.######.#.#...#..#
#.###.#..........#......#
#..#..##.#.###.###.#.#..#
##.#...#.#.....#........#
#..#.#.#.###.###.###.#..#
#....#.#.#.......#.....##
######.....#.#.###.#.#..#
#......#...#.#...#......#
#.###.##.#.#...#.#..###.#
#...#....#.#.###.#.##...#
###.#.#..#.#...#........#
#.....#..#.###.##..##.###
#.###.##.#..#...##......#
#..#...#.##...#..##.#.#.#
#....#...1#...##....#...#
#########################